21 41
21111111111111111111111111111111111111112
10000000000000000000000000000000000000001
10000000000000000000000000000000000000001
10000000000000000000000000000000000000001
10000000000000000000000000000000000000001
10000000000000000000100000000000000000001
10000000000000000000100000000000000000001
10000000000000000000100000000000000000001
10000000000000000000100000000000000000001
10000000000000000000100000000000000000001
10000000001111111111211111111110000000001
10000000000000000000100000000000000000001
10000000000000000000100000000000000000001
10000000000000000000100000000000000000001
10000000000000000000100000000000000000001
10000000000000000000100000000000000000001
10000000000000000000000000000000000000001
10000000000000000000000000000000000000001
10000000000000000000000000000000000000001
10000000000000000000000000000000000000001
21111111111111111111111111111111111111112
